__ __ __ __ __ __ __ __ __ __ __ __ __ __ __ __ __ __ __ __ __ __ __ __ __ __ __ __ __ __ __ __ __ __ __ __ __ __ __ __ __ __ __ __ __ __ __ __ __ __ __ __ __ __ __ __ __ __ __ __ __ __ __ __ __ __ __ __ __ __ __ __ __ __ __ __ __ __ __ __ __ __ __ __ __ __ __ __ __ __ __ __ __ __ __ __ __ __ __ __ __ __ __ __ __ __ __ __ __ __ __ __ __ __ __ __ __ __ __ __ __ __ __ __ __ __ __ __ __ __ __ __ __ __ __ __ __ __ __ __ __ __ __ __ __ __ __ __ __ __ __ __ __ __ __ __ __ __ __ __ __ __ __ __ __ __ __ __ __ __ __ __ __ __ __ __ __ __ __ __ __ __ __ __ __ __ __ __ __ __ __ __ __ __ __ __ __ __ __ __ __ __ __ __ __ __ __ __ __ __ __ __ __ __
__ __ __ __ __ __ __ __ __ __ __ __ __ __ __ __ __ __ __ __ C0 C2 C4 __ __ __ __ __ __ __ __ __ __ __ __ __ __ __ __ __ __ __ __ __ __ __ __ __ __ __ __ __ __ __ __ __ __ __ __ __ __ __ __ __ __ __ __ __ __ C0 C2 C4 __ __ __ __ __ __ __ __ __ __ __ __ __ __ C0 C2 C2 C4 __ __ __ __ __ __ __ __ __ __ __ __ __ __ __ __ __ __ __ __ __ __ __ __ __ __ __ C0 C2 C4 __ __ __ __ __ __ __ __ __ __ __ __ __ __ C0 C2 C2 C4 __ __ __ __ __ __ __ __ __ __ __ __ __ __ __ __ __ __ __ __ __ __ __ __ __ __ __ C0 C2 C4 __ __ __ __ __ __ __ __ __ __ __ __ __ __ C0 C2 C2 C4 __ __ __ __ __ __ __ __ __ __ __ __ __ __ E0 __ __ __ __ __ __ __ __ __ __ __ __ __
__ __ __ __ __ __ __ __ __ C0 C2 C4 __ __ __ __ __ __ __ __ C1 C3 C5 __ __ __ __ __ C0 C2 C2 C2 C4 __ __ __ __ __ __ __ __ __ __ __ __ __ __ __ __ __ __ __ __ __ __ __ __ __ C0 C2 C4 __ __ __ __ __ __ __ __ C1 C3 C5 __ __ __ __ __ C0 C2 C2 C2 C4 __ __ __ __ C1 C3 C3 C5 __ __ __ __ __ __ __ __ __ __ __ __ __ __ __ __ C0 C2 C4 __ __ __ __ __ __ __ __ C1 C3 C5 __ __ __ __ __ C0 C2 C2 C2 C4 __ __ __ __ C1 C3 C3 C5 __ __ __ __ __ __ __ __ __ __ __ __ __ __ __ __ C0 C2 C4 __ __ __ __ __ __ __ __ C1 C3 C5 __ __ __ __ __ C0 C2 C2 C2 C4 __ __ __ __ C1 C3 C3 C5 __ __ __ __ __ __ __ __ __ __ __ __ __ AF E1 __ C0 C2 C4 __ __ __ __ __ __ __ __ __
__ __ __ __ __ __ __ __ __ C1 C3 C5 __ __ __ __ __ __ __ __ __ __ __ __ __ __ __ __ C1 C3 C3 C3 C5 __ __ __ __ __ __ __ __ __ __ __ __ __ __ __ __ __ __ __ __ __ __ __ __ __ C1 C3 C5 __ __ __ __ __ __ __ __ __ __ __ __ __ __ __ __ C1 C3 C3 C3 C5 __G __ __G __ __ __ __ __ __ __ __ __ __ __ __ __ __ __ __ __ __ __ __ __ C1 C3 C5 __ __ __ __ __ __ __ __ __ __ __ __ __ __ __ __ C1 C3 C3 C3 C5 __ __ __ __ __ __ __ __ __ __ __ __ __ __ __ __ __ __ __ __ __ __ __ __ C1 C3 C5 __ __ __ __ __ __ __ __ __ __ __ __ __ __ __ __ C1 C3 C3 C3 C5 __ __ __ __ __ __ __ __ __ __ __ __ __ __ __ __ __ __ __ __ __ __ E1 __ C1 C3 C5 __ __ __ __ __ __ __ __ __
__ __ __ __ __ __ __ __ __ __ __ __ __ __ __ __ __ __ __ __ __ __ __ ?0 __ __ __ __ __ __ __ __ __ __ __ __ __ __ __ __ __ __ __ __ __ __ __ __ __ __ __ __ __ __ __ __ __ __ __ __ __ __ __ __ __ __ __ __ __ __ __ __ __ __ __ __ __ __ __ __ __ __ B0 B0 B0 B0 B0 B0 B0 B0 __ __ __ B0 B0 B0 ?0 __ __ __ __ __ __ __ __ __ __ __ __ __ __ ?1 __ __ __ __ __ __ __ __ __ __ __ B0 B0 B0 __ __ __ __ B0 ?0 ?0 B0 __ __ __ __ __ __ __ __ __ __ __ __ __ __ __ __ __ __ __ __ __ __ __ __ __ __ __ __ __ __ __ __ __ __ __ __ __ __ __ __ __ __ __ __ __ __ __ __ __ __ __ __ __ __ __ __ G1 G1 __ __ __ __ __ __ __ __ E1 __ __ __ __ __ __ __ __ __ __ __ __ __
__ __ __ __ __ __ __ __ __ __ __ __ __ __ __ __ __ __ __ __ __ __ __ __ __ __ __ __ __ __ __ __ __ __ __ __ __ __ __ __ __ __ __ __ __ __ __ __ __ __ __ __ __ __ __ __ __ __ __ __ __ __ __ __ __ __ __ __ __ __ __ __ __ __ __ __ __ __ __ __ __ __ __ __ __ __ __ __ __ __ __ __ __ __ __ __ __ __ __ __ __ __ __ __ __ __ __ __ __ __ __ __ __ __ __ __ __ __ __ __ __ __ __ __ __ __ __ __ __ __ __ __ __ __ __ __ __ __ __ __ __ __ __ __ __ __ __ __ __ __ __ __ __ __ __ __ __ __ __ __ __ __ __ __ __ __ __ __ __ __ __ __ __ __ __ __ __ __ __ __ __ __ __ __ __ __ __ __ __ G1 G1 G1 __ __ __ __ __ __ __ __ E1 __ __ __ __ __ __ __ __ __ __ __ __ __
__ __ __ __ __ __ __ __ __ __ __ __ __ __ __ __ __ __ __ __ __ __ __ __ __ __ __ __ __ __ __ __ __ __ __ __ __ __ __ __ __ __ __ __ __ __ __ __ __ __ __ __ __ __ __ __ __ __ __ __ __ __ __ __ __ __ __ __ __ __ __ __ __ __ __ __ __ __ __ __ __ __ __ __ __ __ __ __ __ __ __ __ __ __ __ __ __ __ __ __ __ __ __ __ __ __ __ __ __ __ __ __ __ __ __ __ __ __ __ __ __ __ __ __ __ __ __ __ __ __ __ __ __ __ __ __ __ __ __ __ __ __ __ __ __ __ __ __ __ __ __ __ __ __ __ __ __ __ __ __ __ __ __ __ __ __ __ __ __ __ __ __ __ __ __ __ __ __ __ __ __ __ __ __ __ __ __ __ G1 G1 G1 G1 __ __ __ __ __ __ __ __ E1 __ __ __ __ __ __ __ __ __ __ __ __ __
__ __ __ __ __ __ __ __ __ __ __ __ __ __ __ __ __ __ __ __ __ __ __ __ __ __ __ __ __ __ __ __ __ __ __ __ __ __ __ __ __ __ __ __ __ __ __ __ __ __ __ __ __ __ __ __ __ __ __ __ WP __ __ __ __ __ H0 __ __ __ __ __ __ __ __ __ __ __ __ __ __ __ __ __ __ __ __ __ __ __ __ __ __ __ __ __ __ __ __ __ __ __ __ __ __ __ __ __ __ __ __ __ __ __ __ __ __ __ __ __ __ __ __ __ __ __ __ __ __ __ __ __ __ __ __ __ __ __ __ __ __ __ __ __ __ __ __ __ __ __ __ __ __ __ __ __ __ __ __ __ __ __ __ __ __ __ __ __ __ __ __ __ __ __ __ __ __ __ __ __ __ __ __ __ __ __ __ G1 G1 G1 G1 G1 __ __ __ __ __ __ __ __ E1 __ __ __ __ F0 F0 F0 __ __ __ __ __ __
__ __ __ __ __ __ __ __ __ __ __ __ __ __ __ __ __ ?0 __ __ __ B0 ?1 B0 ?0 B0 __ __ __ __ __ __ __ __ __ __ __ __ __ __ __ __ __ __ __ __ __ __ P0 P2 __ __ __ __ __ __ __ __ __ P0 P2 __ __ __ __ __ __ __ __ __ __ __ __ __ __ __ __ __ __ B0 ?1 B0 __ __ __ __ __ __ __ __ __ __ __ __ __ __ B1 __ __ __ __ __ B0 B2 __ __ __ __ ?0 __ __ ?0 __ __ ?0 __ __ __ __ __ B0 __ __ __ __ __ __ __ __ __ __ B0 B0 __ __ __ __ __ __ G1 __ __ G1 __ __ __ __ __ __ __ __ __ __ G1 G1 __ __ G1 __ __ __ __ __ __ __ __ __ __ __ __ B0 B0 ?0 B0 __ __ __ __ __ __ __ __ __ __ __ __ G1 G1 G1 G1 G1 G1 __ __ __ __ __ __ __ __ E1 __ __ __ __ F2 F4 F6 __ __ __ __ __ __
__ __ M2 __ __ __ __ __ __ __ __ __ __ __ __ __ __ __ __ __ __ __ __ __ __ __ __ __ __ __ __ __ __ __ __ __ __ __ __ P0 P2 __ __ __ __ __ __ __ P1 P3 __ __ M2 __ __ __ __ __ __ P1 P3 __ __ __ __ __ __ __ __ __ __ __ __ __ __ __ __ __ __ __ __ __ __ __ __ __ __ __ __ __ __ __ __ __ __ __ __ __ __ __ M2 __ __ __ __ __ __ __ __ __ __ __ __ __ __ __ __ __ __ __ __ __ __ __ __ __ __ __ __ __ __ __ __ __ __ __ __ __ G1 G1 __ __ G1 G1 __ __ __ __ M2 __ __ __ G1 G1 G1 __ __ G1 G1 __ __ __ __ __ __ WE __ __ __ __ __ __ __ __ __ __ __ __ __ __ __ __ __ __ __ G1 G1 G1 G1 G1 G1 G1 __ __ __ __ M2 __ __ __ E1 __ __ __ F1 F1 F1 F1 F1 __ __ __ __ __
__ M0 M1 M4 __ __ __ __ __ __ __ __ __ __ __ __ __ __ M2 __ __ __ __ __ __ __ __ __ __ P0 P2 __ __ __ __ __ __ __ __ P1 P3 __ __ __ __ __ __ __ P1 P3 __ M0 M1 M4 __ __ __ __ __ P1 P3 __ __ __ __ __ __ M2 __ __ __ __ __ __ __ __ __ __ __ __ __ __ __ __ __ __ __ __ __ __ __ __ __ __ __ __ __ __ __ M0 M1 M4 __ __ __ __ __ __ __ __ __ __ __ __ __ M2 __ __ __ __ __ __ __ __ __ __ __ __ __ __ __ __ __ __ __ __ __ G1 G1 G1 __ __ G1 G1 G1 __ __ M0 M1 M4 __ G1 G1 G1 G1 __ __ G1 G1 G1 __ __ __ M2 __ P0 P2 __ __ __ __ __ __ __ __ __ __ __ __ __ __ P0 P2 __ G1 G1 G1 G1 G1 G1 G1 G1 __ __ __ M0 M1 M4 __ __ E1 __ __ __ F4 F4 F3 F4 F4 __ __ M2 __ __
M0 M1 M3M M5 M4 __ __ __ __ __ __ __ S1 S3 S3 S3 S5 M0 M1 M4 __ __ __ __G S1 S3 S5 __ __ P1 P3 __ __ __ __ __ __ __ __ P1 P3 __G S1 S3 S3 S5 __ __ P1 P3 M0 M1 M3 M5G M4 __G __ __ __ P1 P3 S1 S3 S3 S3 S5 M0 M1 M4 __ __ __ __ S1 S3 S5 __ __ __ __ __ __ __ __ __ __ __ __ __ __ __ S1 S3 S3 S5 __ __ __ M0 M1G M3 M5G M4 __ __ __ __ __ __ S1K S3 S3 S3 S5 M0 M1 M4G __ __G __ __ S1 S3 S5 __ __ __G __ __G __ __G __ __G __ __ __ G1 G1 G1 G1 S3 S3 G1 G1 G1 G1 M0 M1 M3 M5 G1 G1 G1 G1 G1 __ __ G1 G1 G1 G1 S5 M0 M1 M4 P1 P3 __ __ S1 S3 S5 __ __ __ __ __G __ __G __ __ P1 P3 G1 G1 G1 G1 G1 G1 G1 G1 G1 __ __ M0 M1 M3 M5 M4 __ G1 __ __ __ F4 F4 F5 F4 F4 S5 M0 M1 M4 __
G0 G0 G0 G0 G0 G0 G0 G0 G0 G0 G0 G0 G0 G0 G0 G0 G0 G0 G0 G0 G0 G0 G0 G0 G0 G0 G0 G0 G0 G0 G0 G0 G0 G0 G0 G0 G0 G0 G0 G0 G0 G0 G0 G0 G0 G0 G0 G0 G0 G0 G0 G0 G0 G0 G0 G0 G0 G0 G0 G0 G0 G0 G0 G0 G0 G0 G0 G0 G0 G0 G0 __ __ G0 G0 G0 G0 G0 G0 G0 G0 G0 G0 G0 G0 G0 G0 G0 __ __ __ G0 G0 G0 G0 G0 G0 G0 G0 G0 G0 G0 G0 G0 G0 G0 G0 G0 G0 G0 G0 G0 G0 G0 G0 G0 G0 G0 G0 G0 G0 G0 G0 G0 G0 G0 G0 G0 G0 G0 G0 G0 G0 G0 G0 G0 G0 G0 G0 G0 G0 G0 G0 G0 G0 G0 G0 G0 G0 G0 G0 G0 G0 G0 G0 __ __ G0 G0 G0 G0 G0 G0 G0 G0 G0 G0 G0 G0 G0 G0 G0 G0 G0 G0 G0 G0 G0 G0 G0 G0 G0 G0 G0 G0 G0 G0 G0 G0 G0 G0 G0 G0 G0 G0 G0 G0 G0 G0 G0 G0 G0 G0 G0 G0 G0 G0 G0 G0 G0 G0 G0 G0 G0
G0 G0 G0 G0 G0 G0 G0 G0 G0 G0 G0 G0 G0 G0 G0 G0 G0 G0 G0 G0 G0 G0 G0 G0 G0 G0 G0 G0 G0 G0 G0 G0 G0 G0 G0 G0 G0 G0 G0 G0 G0 G0 G0 G0 G0 G0 G0 G0 G0 G0 G0 G0 G0 G0 G0 G0 G0 G0 G0 G0 G0 G0 G0 G0 G0 G0 G0 G0 G0 G0 G0 __ __ G0 G0 G0 G0 G0 G0 G0 G0 G0 G0 G0 G0 G0 G0 G0 __ __ __ G0 G0 G0 G0 G0 G0 G0 G0 G0 G0 G0 G0 G0 G0 G0 G0 G0 G0 G0 G0 G0 G0 G0 G0 G0 G0 G0 G0 G0 G0 G0 G0 G0 G0 G0 G0 G0 G0 G0 G0 G0 G0 G0 G0 G0 G0 G0 G0 G0 G0 G0 G0 G0 G0 G0 G0 G0 G0 G0 G0 G0 G0 G0 G0 __ __ G0 G0 G0 G0 G0 G0 G0 G0 G0 G0 G0 G0 G0 G0 G0 G0 G0 G0 G0 G0 G0 G0 G0 G0 G0 G0 G0 G0 G0 G0 G0 G0 G0 G0 G0 G0 G0 G0 G0 G0 G0 G0 G0 G0 G0 G0 G0 G0 G0 G0 G0 G0 G0 G0 G0 G0 G0